111111111111111
110000000000011
100000000000001
100000000000001
100000000000001
100000000000001
100000000000001
100000300000001
100000000000001
100000000000001
100000000000001
100000000000001
100000000000001
110000000000011
111111111111111