111111111111111
111111111111111
111111111111111
111111111111111
110000000000011
110000000000011
110000000040011
110000000000011
110030000000011
110000000000011
110000000000011
111111111111111
111111111111111
111111111111111
111111111111111