111111111111111
100000000000001
100000000000001
100000000000001
100000000010001
100000000010001
100004000010001
100000000010001
100000000010001
100000000010001
111111111112221
100000500000001
103000000000001
100000000000001
111111111111111