111111111111111
100000000000001
100000000000001
100000000000001
100011111110001
100010000010001
100010040010001
100000000010001
100000000010001
100000000010001
111111111110001
100000000000001
103000000000001
100000000000001
111111111111111