111111111111111
100000000000001
100000000000001
100000000400001
100000000000001
100000000000001
100000000000001
100000000000001
100000000000001
100000000000001
100000000000001
100000000000001
100300000000001
100000000000001
111111111111111