111111111111111
100000002000001
103000002000001
100000002000001
111111111222221
100000001000001
100000001000001
100000001000001
100012221000001
100010401000001
122211111000001
100000000000001
100000000000001
100000000000001
111111111111111