111111111111111
150510000000001
103020000000001
100010000000001
111111111110001
100000000010001
100000000010001
100010000010001
100005010010001
100004000010001
100100000010001
100000100020001
100000000020001
100000000020001
111111111111111