111111111111111
155555555520001
155554555510001
155555555510001
151111155110001
151000155100001
151030155100001
151000155100001
151000155100001
151000155100001
151000111100001
151000000000001
151000000000001
141000000000001
111111111111111