111111111111111
125000000000251
101111111111101
101450000002101
151111111115101
120000000052101
111111111111121
155555555555551
100000000000001
100000000000001
121111111111111
102222222222201
111111111111121
130000000000051
111111111111111